800000000
003600000
070090200
060005030
000040070
000100080
001806040
008500010
090000400
